15 15 1.5 1.5 1.
############### 
#  #   #   #  #
##   #   #   ##
##########    #
#             #
# #############
#             #
############  #
#          #  #
# ########   ##
#         #####
#########     #
#       #     #
#       #     #
###############